1111111111
1S00000001
1011111101
1000000101
1011110101
1010000101
1010111101
10000000E1
1111111111